1111111111111111
1111111P11111111
1111000000000111
1100000000000011
1000000000000001
100000C000000001
100000C000000001
1000CCCCC0000001
110000C000000011
111000C0000001E1
111000C000001001
110110C000011001
1101100001100011
1101110011100111
1000000000000111
1111111111111111