11111111111111111111
1E000C0000C000000001
10111111111111110011
10100C000C00001001C1
1010111CC11110101C01
1010100000C010100101
10101011111110101001
101010100000C0100101
10C01010111110101C01
101010100P0010100101
10101011111110101C01
10101000000010100101
10101111111110101001
10100000000000100101
10111111111111110001
1000000CCCC000000011
11111111111111111111